{
  "1" : [
    [".", ".", ".", ".", ".", ".", "X", ".", ".", ".", "L", ".", "@"],
    [".", ".", ".", "#", ".", ".", ".", "#", "#", "#", "#", ".", "@"],
    ["#", "#", "#", ".", ".", ".", ".", ".", ".", ".", ".", ".", "."],
    [".", "Q", ".", ".", "#", "#", "#", ".", ".", "~", "~", "#", "."],
    ["~", "~", "~", ".", "L", ".", "#", ".", ".", ".", ".", ".", "."],
    ["~", "~", "~", ".", ".", ".", "#", ".", "#", "#", "#", "#", "@"],
    [".", ".", "@", ".", ".", ".", ".", ".", "#", ".", ".", "#", "@"],
    [".", "@", "@", "D", "#", "@", "@", ".", "#", ".", "Q", "#", "@"],
    [".", ".", "@", "#", "#", "@", "@", "@", "#", ".", "D", "#", "."],
    ["@", ".", "~", ".", ".", "@", "@", "@", "#", "#", "#", "#", "."],
    [".", "~", ".", "L", "D", "@", "@", ".", "Q", ".", ".", ".", "."],
    [".", "~", "~", ".", ".", ".", ".", "@", ".", ".", "~", "~", "~"],
    ["@", ".", ".", "#", ".", "@", "$", "@", ".", ".", ".", "~", "."]
],
  "2" : [
    [".", ".", ".", ".", ".", ".", ".", ".", ".", ".", ".", ".", "."],
    [".", ".", ".", ".", ".", ".", ".", ".", ".", ".", ".", ".", "."],
    [".", ".", ".", ".", ".", ".", ".", ".", ".", ".", ".", ".", "."],
    [".", ".", ".", ".", ".", ".", ".", ".", ".", ".", ".", ".", "."],
    [".", ".", ".", ".", ".", ".", ".", ".", ".", ".", ".", ".", "."],
    [".", ".", ".", ".", ".", ".", ".", ".", ".", ".", ".", ".", "."],
    [".", ".", ".", ".", ".", ".", ".", ".", ".", ".", ".", ".", "."],
    [".", ".", ".", ".", ".", ".", ".", ".", ".", ".", ".", ".", "."],
    [".", ".", ".", ".", ".", ".", ".", ".", ".", ".", ".", ".", "."],
    [".", ".", ".", ".", ".", ".", ".", ".", ".", ".", ".", ".", "."],
    [".", ".", ".", ".", ".", ".", ".", ".", ".", ".", ".", ".", "."],
    [".", ".", ".", ".", ".", ".", ".", ".", ".", ".", ".", ".", "."],
    [".", ".", ".", ".", ".", ".", ".", ".", ".", ".", ".", ".", "."]
],
  "3" : [
    [".", ".", ".", ".", ".", ".", ".", ".", ".", ".", ".", ".", "."],
    [".", ".", ".", ".", ".", ".", ".", ".", ".", ".", ".", ".", "."],
    [".", ".", ".", ".", ".", ".", ".", ".", ".", ".", ".", ".", "."],
    [".", ".", ".", ".", ".", ".", ".", ".", ".", ".", ".", ".", "."],
    [".", ".", ".", ".", ".", ".", ".", ".", ".", ".", ".", ".", "."],
    [".", ".", ".", ".", ".", ".", ".", ".", ".", ".", ".", ".", "."],
    [".", ".", ".", ".", ".", ".", ".", ".", ".", ".", ".", ".", "."],
    [".", ".", ".", ".", ".", ".", ".", ".", ".", ".", ".", ".", "."],
    [".", ".", ".", ".", ".", ".", ".", ".", ".", ".", ".", ".", "."],
    [".", ".", ".", ".", ".", ".", ".", ".", ".", ".", ".", ".", "."],
    [".", ".", ".", ".", ".", ".", ".", ".", ".", ".", ".", ".", "."],
    [".", ".", ".", ".", ".", ".", ".", ".", ".", ".", ".", ".", "."],
    [".", ".", ".", ".", ".", ".", ".", ".", ".", ".", ".", ".", "."]
],
  "4" : [
    [".", ".", ".", ".", ".", ".", ".", ".", ".", ".", ".", ".", "."],
    [".", ".", ".", ".", ".", ".", ".", ".", ".", ".", ".", ".", "."],
    [".", ".", ".", ".", ".", ".", ".", ".", ".", ".", ".", ".", "."],
    [".", ".", ".", ".", ".", ".", ".", ".", ".", ".", ".", ".", "."],
    [".", ".", ".", ".", ".", ".", ".", ".", ".", ".", ".", ".", "."],
    [".", ".", ".", ".", ".", ".", ".", ".", ".", ".", ".", ".", "."],
    [".", ".", ".", ".", ".", ".", ".", ".", ".", ".", ".", ".", "."],
    [".", ".", ".", ".", ".", ".", ".", ".", ".", ".", ".", ".", "."],
    [".", ".", ".", ".", ".", ".", ".", ".", ".", ".", ".", ".", "."],
    [".", ".", ".", ".", ".", ".", ".", ".", ".", ".", ".", ".", "."],
    [".", ".", ".", ".", ".", ".", ".", ".", ".", ".", ".", ".", "."],
    [".", ".", ".", ".", ".", ".", ".", ".", ".", ".", ".", ".", "."],
    [".", ".", ".", ".", ".", ".", ".", ".", ".", ".", ".", ".", "."]
],
  "5" : [
    [".", ".", ".", ".", ".", ".", ".", ".", ".", ".", ".", ".", "."],
    [".", ".", ".", ".", ".", ".", ".", ".", ".", ".", ".", ".", "."],
    [".", ".", ".", ".", ".", ".", ".", ".", ".", ".", ".", ".", "."],
    [".", ".", ".", ".", ".", ".", ".", ".", ".", ".", ".", ".", "."],
    [".", ".", ".", ".", ".", ".", ".", ".", ".", ".", ".", ".", "."],
    [".", ".", ".", ".", ".", ".", ".", ".", ".", ".", ".", ".", "."],
    [".", ".", ".", ".", ".", ".", ".", ".", ".", ".", ".", ".", "."],
    [".", ".", ".", ".", ".", ".", ".", ".", ".", ".", ".", ".", "."],
    [".", ".", ".", ".", ".", ".", ".", ".", ".", ".", ".", ".", "."],
    [".", ".", ".", ".", ".", ".", ".", ".", ".", ".", ".", ".", "."],
    [".", ".", ".", ".", ".", ".", ".", ".", ".", ".", ".", ".", "."],
    [".", ".", ".", ".", ".", ".", ".", ".", ".", ".", ".", ".", "."],
    [".", ".", ".", ".", ".", ".", ".", ".", ".", ".", ".", ".", "."]
]
}
